Cell	cell_type
AACACTTGGCAAGGAA-1	SMC
AACAGGTTATTGCACC-1	Macrophage
AACCACTGCCATAGCC-1	Fibroblast
AACCTACAGAGGTAGT-1	Endothelial
AACGAAGCGTGGAAGT-1	Endothelial
AACGAGCTAATAACTA-1	SMC
AACTAGCACTGTTCGA-1	Endothelial
AACTAGCCTTGCAATA-1	Endothelial
AACTCACCGAACTTAT-1	Fibroblast
AACTCACCTCGGTGTT-1	Fibroblast
AACTGCCTCGATAGGT-1	Adipocyte
AAGACTGTCATAGTGC-1	SMC
AAGATGAAGGTCATCG-1	Fibroblast
AAGATTATCTAGCATA-1	SMC
AAGCCACTATGTCTAA-1	SMC
AAGCCAGGCCGACGTG-1	SMC
AAGCGAGGAAGTGAAC-1	Endothelial
AAGGAGGCACTCAATT-1	Endothelial
AAGGCCGACCTACCTG-1	Adipocyte
AAGGCGAGGTTCATGT-1	SMC
AAGGCGCCTAACATAG-1	SMC
AAGGTTGCAGAAGCAG-1	SMC
AAGTACTACAGTAGAA-1	SMC
AAGTCTGTCAATTCTT-1	Fibroblast
AAGTCTTAAGTTGCCA-1	SMC
AAGTGGACGAATCTAC-1	Fibroblast
AAGTGGCGAGTGTACA-1	Endothelial
AAGTTCCTATTGCTGG-1	Endothelial
AATAACGTAACTGTGA-1	SMC
AATAACTCTACGATGT-1	Endothelial
AATAGTGCTCATAGAA-1	Adipocyte
AATATTAGGCTTCTGG-1	SMC
AATCCGCCTGGTCAAT-1	SMC
AATGAAGACGGTTCAG-1	Macrophage
AATGAATCGGAAGGCA-1	SMC
AATGATTACAACCTAA-1	Adipocyte
AATGCAATCACTGTCG-1	Endothelial
AATGGACATCCTACTC-1	Macrophage
AATGGCATAGTATCAT-1	Adipocyte
AATGGTGCGTCCTAAC-1	Fibroblast
AATGTCAGGTCATTAC-1	Adipocyte
AATTCTCGCACCAGTA-1	Macrophage
AATTGCATTGAAGAAT-1	Adipocyte
ACAACTAAGGTGTTAT-1	Fibroblast
ACAATACGCCTTATTC-1	Endothelial
ACAGAATCCGTTGCTT-1	Fibroblast
ACAGAATGTCTTATTG-1	Macrophage
ACAGCCAGGCATAAGC-1	Endothelial
ACAGGAACTACAGAAC-1	Fibroblast
ACATCGCCACAAGAGG-1	Fibroblast
ACATGGATGCGTAAGC-1	Fibroblast
ACATTGGTTCACAGTG-1	SMC
ACCAAGTGATGGTGAG-1	Fibroblast
ACCAAGTGGCTGTATG-1	SMC
ACCAGTATGAAGTTCC-1	SMC
ACCATTAGATCGTGGC-1	SMC
ACCGATTGAGGATCTG-1	Fibroblast
ACCGGCACCATACTGC-1	Fibroblast
ACCGGCCTCAGGAGTT-1	Endothelial
ACCGGCTATCGTGCGG-1	SMC
ACCGTACACGACCGTC-1	Fibroblast
ACCTAAGTAGAACAGA-1	Fibroblast
ACCTGCCACTATCAAT-1	Endothelial
ACCTGCTTATAGTTCG-1	Fibroblast
ACCTGCTTGAGCCTGG-1	SMC
ACCTGTGGTCACCTCG-1	SMC
ACGAACGCACGAGCAC-1	Adipocyte
ACGACTGAAGACTTAC-1	Endothelial
ACGATGTTACCTCATT-1	SMC
ACGGCTTCCATCGGAA-1	SMC
ACGGCTTGTTCAATCG-1	Endothelial
ACGGTTACATCCGAAG-1	Fibroblast
ACGGTTCGTACAGTTG-1	SMC
ACGGTTCGTCCGACCG-1	Endothelial
ACGTCAGATTACTTCG-1	Endothelial
ACGTTCACGACTAGGT-1	SMC
ACGTTCCATTACCTCA-1	SMC
ACTAGATCTGAAGCGG-1	Fibroblast
ACTATGAGGTTCTGTC-1	SMC
ACTATTAGACAGGCTG-1	Fibroblast
ACTCAGGCCTGCAACT-1	Fibroblast
ACTCAGTGAGCCTCCA-1	Adipocyte
ACTCCAGGCCGAAGAC-1	Fibroblast
ACTCCAGTAGCTCCAG-1	Fibroblast
ACTCGATTGATATCCA-1	Endothelial
ACTTGAAGCGAGCGGT-1	Adipocyte
AGAACAGGAGCATGGA-1	Adipocyte
AGAACTTCGATGCGTA-1	Adipocyte
AGAAGGATGGTATGAA-1	SMC
AGAAGTTGAGCGCAAG-1	Endothelial
AGACAAGACGTATCGC-1	Fibroblast
AGACGCGTGATGCATC-1	SMC
AGACGCTTGGCCTCAC-1	Endothelial
AGACGTAGGCGGACCG-1	SMC
AGACTCATTGCGGACA-1	Macrophage
AGACTCCTGTATGGCG-1	SMC
AGACTCTATTAGCGCT-1	SMC
AGCACGGAGGCAGTCA-1	SMC
AGCCGGCCTATTCCAG-1	SMC
AGCCGTATCTTCGTCT-1	Fibroblast
AGCCTCCGAACTACCA-1	Endothelial
AGCCTCTATGCAGCAA-1	SMC
AGCGAGAACAGATTCT-1	SMC
AGCGGTGAGTGACATG-1	Adipocyte
AGCGTGCGCCTGATCG-1	Endothelial
AGCGTGGCACCGACAA-1	Adipocyte
AGCGTGTATGTACGGT-1	Fibroblast
AGCTAGCGTACAGTAA-1	Fibroblast
AGCTGTCCAGATGCTA-1	Fibroblast
AGGACGTATCGCCGTA-1	SMC
AGGACGTCGGCACGAA-1	Adipocyte
AGGACTAGGACCGCAG-1	Endothelial
AGGACTGGATGAAGAC-1	Endothelial
AGGATAACCGGTCGGA-1	SMC
AGGATCAACATTCGTT-1	Endothelial
AGGCATTAAGTCTGGC-1	SMC
AGGCCGCAGAATAACG-1	Endothelial
AGGCCTGTCTAGTGGC-1	Fibroblast
AGGTCTTCCATCGCCG-1	Macrophage
AGGTGAAGTGACGACT-1	Macrophage
AGGTTAGTGGCCATAG-1	SMC
AGTAACCGCAGGTCAA-1	Fibroblast
AGTAAGCTCGGCCAAT-1	Adipocyte
AGTACCGTTGTACGCC-1	SMC
AGTAGACAGTAAGGAG-1	Adipocyte
AGTAGAGCATGGACGT-1	SMC
AGTATTCAGCTGAATG-1	SMC
AGTATTCGTCGGTATC-1	Endothelial
AGTATTGGTATGTCTA-1	Fibroblast
AGTCGCCACTCGGCGA-1	Macrophage
AGTCGGACCGTGCTTA-1	Adipocyte
AGTCGGTCTAATCTGT-1	Fibroblast
AGTGTCTAGGCTAATA-1	SMC
AGTTATCCTGAACGAA-1	Endothelial
AGTTCGGCACATACGG-1	SMC
AGTTCGTGCAGACCTT-1	Fibroblast
AGTTGTACTTAATGGA-1	Adipocyte
AGTTGTCCACAGACCA-1	Endothelial
ATAACCTAGAACCTGC-1	SMC
ATAAGACCAATCGCGG-1	SMC
ATAAGGAATAGAACAT-1	SMC
ATACAAGGTCAGTAGA-1	Adipocyte
ATACATCAAGGATTGC-1	Macrophage
ATACATCATGCACCAA-1	Fibroblast
ATACGCTGAGATCAGA-1	Macrophage
ATACTAGCCATTAGTT-1	Endothelial
ATACTGGAGGATAACG-1	Endothelial
ATAGAACCTCTACCGA-1	SMC
ATAGATGCCTAAGCAC-1	Macrophage
ATAGTGAGTGAGGATT-1	Adipocyte
ATAGTTCGCAGCCGTG-1	Adipocyte
ATCACCAGTTCGGCGA-1	SMC
ATCACTTAGGCCTTGT-1	Fibroblast
ATCATTCACCAGATTG-1	SMC
ATCATTGTCCATGCCA-1	Macrophage
ATCCGAGTACCACGTG-1	Endothelial
ATCCGGATGACGTAAC-1	Fibroblast
ATCCGGTACCGTCCTT-1	SMC
ATCCGGTATCACAAGT-1	SMC
ATCCGTAGCTTCAGTA-1	SMC
ATCCGTAGTGTCGCTC-1	Fibroblast
ATCCTCGTTCCAGGCC-1	Fibroblast
ATCGCAATGCACTAAC-1	Macrophage
ATCGCAGTAACTTATT-1	SMC
ATCGCAGTCTATGGCA-1	SMC
ATCGGCTCTATGCCTC-1	Fibroblast
ATCGTACACCTATGCC-1	SMC
ATCGTCACCATGTCAC-1	Macrophage
ATCGTCAGTTAGTCCA-1	Endothelial
ATCTCCTTGCGATACA-1	Macrophage
ATCTGAGGAACGGTTG-1	SMC
ATCTTAGTGGCATGGA-1	SMC
ATCTTGGCTTCGTCCT-1	Endothelial
ATGAATGTATCGTGGT-1	Endothelial
ATGACCTCACTTAACC-1	SMC
ATGATATCTAGTCTTA-1	Macrophage
ATGCATGGTTCCGCCT-1	Macrophage
ATGCTGAATGCAATAG-1	SMC
ATGCTGCCGGCATACT-1	Fibroblast
ATGCTTGGACGAACTT-1	SMC
ATGGAGTAATCGGACC-1	Adipocyte
ATGGCATTATGGCTCG-1	Adipocyte
ATGTAATTGTCGTTCG-1	Fibroblast
ATGTACATGAACTCCG-1	SMC
ATGTACTACCGACTTC-1	SMC
ATGTAGGTAACCGTAC-1	Fibroblast
ATTAAGAACAGCTCCG-1	Macrophage
ATTACATTGAAGTATG-1	Fibroblast
ATTACTCCGTGAAGCG-1	Adipocyte
ATTAGATAAGACGGCG-1	SMC
ATTAGCCTCACTTCTA-1	Endothelial
ATTATCACAACTCGGC-1	Fibroblast
ATTCACATCTTATTCT-1	SMC
ATTCACCTGACCAGTT-1	Fibroblast
ATTCACGCTGTTATCG-1	Fibroblast
ATTCACTCACGTGCAC-1	SMC
ATTCAGCTCCTACTAA-1	Endothelial
ATTCATAGCGAAGCGT-1	SMC
ATTCCGCAACGCCGCT-1	Adipocyte
ATTCCGGTTACATACC-1	SMC
ATTCCGTAAGGATTCC-1	Endothelial
ATTCCTGCCTTAACAG-1	SMC
ATTCGCTCGCGGAGGC-1	Endothelial
ATTCTAGGACATCAGT-1	Endothelial
ATTGCATCACTGACTG-1	Fibroblast
CAACAGGTCAGAGGAC-1	Fibroblast
CAACCGTATTACTGTA-1	Endothelial
CAACGCTTGCTCCTAC-1	Macrophage
CAACTGCAGTGCAATA-1	Macrophage
CAAGACCACTATCGAA-1	Macrophage
CAAGCCGCCATAGAGG-1	Endothelial
CAAGTGTTCGCCACGC-1	SMC
CAATAAGCGGCCAGAT-1	Fibroblast
CAATTGAACCGGCTCG-1	SMC
CACCTAGACGAGCCGG-1	Adipocyte
CACCTCGAGCGATGCT-1	Fibroblast
CACGCCACAATCGCAC-1	Endothelial
CACGTAGGTAGGCTGA-1	Endothelial
CACGTCAAGTGCGATC-1	Endothelial
CACTACTGCGGAATTG-1	SMC
CACTACTGGCTGAACC-1	Endothelial
CACTGGCCAGCCAGAT-1	Macrophage
CACTTGACATTCAGAA-1	Macrophage
CAGAACATGATAGGAC-1	Fibroblast
CAGAAGTCGCGGTTAT-1	Adipocyte
CAGACGAATGAGGAAC-1	Adipocyte
CAGATTGCCTGTAAGT-1	Macrophage
CAGCCAGTCCTGTCGG-1	Adipocyte
CAGCTCCTCGGATTCT-1	Endothelial
CAGGACATGGTAATGC-1	SMC
CAGTACAGTTGTGGAA-1	Macrophage
CAGTATGCGTGGCGCT-1	SMC
CAGTCAGCCGATCCGG-1	SMC
CAGTGAACAGCAACGA-1	SMC
CAGTTGCTCACGTGTC-1	Fibroblast
CATAGAACATTGAACA-1	Endothelial
CATCAGATACTAATCG-1	Macrophage
CATCAGGTGCCTGATA-1	Endothelial
CATCCGAAGCGTATGG-1	Fibroblast
CATCGCGGTCGGTGCG-1	Adipocyte
CATGCGCTACTGGAGG-1	Fibroblast
CATTAACTATTGTTCC-1	Macrophage
CATTAGGATAGTGAAT-1	Endothelial
CATTAGGCAATGGTTA-1	SMC
CCAACTTGCCACCGTA-1	SMC
CCAATCTTGCCTATGG-1	Macrophage
CCAGACAATATCGTTA-1	Macrophage
CCAGACAGAACCTAAG-1	Adipocyte
CCAGACATCCGGTTCT-1	Endothelial
CCAGATAGACGAGGTG-1	SMC
CCATAGTATTGTCTGC-1	Fibroblast
CCATCTGTGGCATCGT-1	SMC
CCATGAACATCGTTGG-1	Fibroblast
CCATTCGTCTGCTCTA-1	Fibroblast
CCGACAAGACTGTACT-1	Macrophage
CCGACAGACTGTGCCT-1	Endothelial
CCGAGGATGACTCGTC-1	Macrophage
CCGATGGAACATCAGC-1	Adipocyte
CCGATTCCTCACTACA-1	Adipocyte
CCGCGTCGTTGGTCTG-1	Endothelial
CCGCGTTACCTTGGCG-1	Fibroblast
CCGCTGTCACCTGCAA-1	SMC
CCGCTGTTGCCATACG-1	Macrophage
CCGGCGAACATCACGT-1	Fibroblast
CCGGCGAACCGTGCAC-1	SMC
CCGGCGTCTTAATAAG-1	Adipocyte
CCGTGAAGGATAACAG-1	SMC
CCTAACTTATGTTGGA-1	Fibroblast
CCTAAGCATGCCTTGT-1	Adipocyte
CCTAATCCACAAGGAT-1	Endothelial
CCTAATGGCACTGTTC-1	Endothelial
CCTACCACTCCAGTTA-1	Macrophage
CCTACGAGCTGGCCGG-1	SMC
CCTAGCCTTCATCGGC-1	SMC
CCTATGCCTTCTTGTT-1	Adipocyte
CCTCACGTTACTCGCA-1	Fibroblast
CCTCGATAGAATAGGA-1	SMC
CCTCTACCGTGATTGG-1	Adipocyte
CCTCTTCGAGCGGTTG-1	Fibroblast
CCTGGATCTAGAGCCA-1	SMC
CCTGTCTAAGTAGGCT-1	Fibroblast
CCTGTCTGATAGGTGA-1	SMC
CCTGTCTGCATAGGTC-1	Adipocyte
CCTTGTCTACTTAGAC-1	Fibroblast
CCTTGTGATGGTCTAG-1	Macrophage
CGAACCAGAAGTCTGG-1	Fibroblast
CGAATGGACCGTCTTG-1	Adipocyte
CGACAAGTACTCCTTA-1	Endothelial
CGACCAGAAGGATCCG-1	Adipocyte
CGACCAGCCTTGATTA-1	Adipocyte
CGAGATGCCGCATCTT-1	Endothelial
CGAGCGGCACAGTAGG-1	Endothelial
CGAGCTTAGAATACCT-1	SMC
CGAGGAGTCTAAGGAT-1	SMC
CGAGGATTCGATCATA-1	Adipocyte
CGAGTGCGGCTCGTGG-1	Adipocyte
CGATAAGAATTCCAGT-1	Adipocyte
CGATGAGGCCAACGTA-1	Macrophage
CGATGCACCAGGCCTC-1	SMC
CGATGTCCGACTACAG-1	Macrophage
CGCAACCATGCACCGA-1	SMC
CGCACGGCTGTCAGGT-1	Fibroblast
CGCACTGTGAGCCTGT-1	Endothelial
CGCATCTTGACTTAGT-1	Endothelial
CGCATGAGGAGCGTCT-1	Adipocyte
CGCCTCGAGCCACTCG-1	Adipocyte
CGCCTCGGAACTGTGC-1	Endothelial
CGCCTTATCTTGGCGA-1	Macrophage
CGCTATAGTCTTCATC-1	Endothelial
CGCTATTATGATACGT-1	Endothelial
CGCTGCTATGACAGAC-1	Endothelial
CGCTTATGGTTAGGAT-1	Macrophage
CGCTTGGCTTGGATCT-1	Fibroblast
CGGACTGTGAGTATAG-1	Fibroblast
CGGCAACCACTAGCAT-1	Endothelial
CGGCATTATCGCGTGG-1	Endothelial
CGGTATAGGATGAGCG-1	Fibroblast
CGGTGAGCATGTATAC-1	Fibroblast
CGGTTATCTGTCTTAA-1	SMC
CGTAACATTCGCGATA-1	Adipocyte
CGTAACATTGGCTGAG-1	SMC
CGTACAGACGAGGACC-1	Fibroblast
CGTACAGTAAGTAATG-1	Fibroblast
CGTAGTACGCATAATG-1	Macrophage
CGTAGTTCGTTGGTAG-1	SMC
CGTCCATCGTCCAATA-1	Adipocyte
CGTGTAGACACCTTCC-1	SMC
CGTTGTGAGCAAGTGG-1	Adipocyte
CTAACAGTATACCGGC-1	Macrophage
CTAATCTGGCCGTGTT-1	SMC
CTAATGACATCATTCT-1	SMC
CTAATGAGCGAGGCTA-1	SMC
CTACAACCGCTGTCTA-1	Endothelial
CTACAGATCGGTCGCC-1	SMC
CTACAGCGTCTACACT-1	SMC
CTACATCTACTGGCTT-1	Macrophage
CTACGCTTAGAAGTGC-1	SMC
CTACTGCTCCGACAGT-1	SMC
CTATAGATCCACAAGC-1	SMC
CTATCGGATATCGGAG-1	SMC
CTATGCCGTACAGCGT-1	Macrophage
CTATGTGCGGTTGACT-1	Adipocyte
CTATTAGCGGCTTCGT-1	Fibroblast
CTATTCTGTAGGACCT-1	Fibroblast
CTCAATGACCATTAAG-1	Macrophage
CTCACCTGAGACTAAG-1	SMC
CTCACCTGCCGACTAA-1	SMC
CTCACGTATTCAAGCG-1	Fibroblast
CTCACGTTCGGTCTGC-1	Adipocyte
CTCATAATAGCACCGT-1	Fibroblast
CTCATAGCCAATGTCG-1	SMC
CTCCGGCCTACAGCTT-1	SMC
CTCCTACATTGTATCT-1	Macrophage
CTCCTACCTCGTGGTA-1	Fibroblast
CTCCTTATCTTAAGAC-1	SMC
CTCGACAGCACTCGGA-1	SMC
CTCGACTCCTAATGGA-1	Macrophage
CTCGCTGTTCATAGAT-1	Endothelial
CTCGGATCGGAATACG-1	Fibroblast
CTCGTTCTGTCACGTT-1	Fibroblast
CTGAAGGTGCTCGAGG-1	Fibroblast
CTGACTGTGGCCGGTT-1	Endothelial
CTGCCGATTGCGATGT-1	Fibroblast
CTGCCGTGAAGTCGCA-1	Adipocyte
CTGCTCATTAGAGTGC-1	SMC
CTGGAATAGTGCAAGT-1	SMC
CTGGAATGGATCAGCA-1	Endothelial
CTGGCGCATATCCGTG-1	SMC
CTGGTGCGTTCACGAG-1	SMC
CTGGTGGCCAATAAGT-1	Macrophage
CTGTATCTTCGCCATA-1	Macrophage
CTGTCAGATCGATGCG-1	Fibroblast
CTGTGGCTTGTCAGCT-1	Endothelial
CTTACGACAACGATAC-1	Fibroblast
CTTACGCAACTCAACG-1	SMC
CTTACGGTAAGCCGAA-1	Macrophage
CTTACGTCATCCTTAT-1	SMC
CTTAGCAAGGACAGCC-1	Endothelial
CTTAGCTTAGTTCTCG-1	Adipocyte
CTTAGTCTATCGAGAC-1	Adipocyte
CTTAGTCTCGACAACT-1	SMC
CTTAGTTGCTCGTTGT-1	SMC
CTTCAAGTCGACCTTC-1	Adipocyte
CTTCCAATTGAAGATT-1	Fibroblast
CTTCCGTCGCTGCATC-1	SMC
CTTCGACTCCAGACTG-1	Endothelial
CTTCGAGCTGCAGCCT-1	Fibroblast
CTTCGATAACATTGGT-1	Adipocyte
CTTCGATATGTAGGAG-1	SMC
CTTGAGTCTTACAGTG-1	Endothelial
CTTGGAACTCCACGCC-1	Fibroblast
CTTGGTTAGAGTCATC-1	SMC
CTTGTATCGTATGATT-1	Endothelial
GAACATTCGACACGTA-1	Endothelial
GAACGCTAGAAGGCTA-1	SMC
GAACTAACTCTACGTG-1	SMC
GAACTACCTTATCATA-1	Adipocyte
GAACTGTAACTCAGGC-1	Adipocyte
GAATAAGGAGAACTAA-1	Macrophage
GAATGACACGACTAGG-1	Macrophage
GACAACGGACTCAGCT-1	Fibroblast
GACAATCTATTAGATT-1	Fibroblast
GACCACATTCTTGAAT-1	SMC
GACCACTCCTGACGTT-1	SMC
GACCGGCCATGTACCG-1	Macrophage
GACGCTCACCAACCGG-1	Endothelial
GACGGCTTAGGTGCGA-1	Fibroblast
GACTACGAGTTCCATT-1	Adipocyte
GACTAGTAATCTTGCT-1	SMC
GACTGCGGTCTGCGTG-1	SMC
GAGCCTCACGTATGTA-1	SMC
GAGCTAACCTACTTAC-1	Endothelial
GAGGATCCAGAACTGG-1	SMC
GAGGATGATAGGAAGG-1	SMC
GAGGCCAGCAGAGGTT-1	Fibroblast
GAGGCGCTCCATTCCT-1	Fibroblast
GAGGTAACTAGACAGT-1	SMC
GAGGTATTAATAGCGG-1	Adipocyte
GAGGTGCATTCGGATC-1	Macrophage
GAGTAGATTATGGTTC-1	SMC
GAGTAGGATGGTAGTC-1	Macrophage
GAGTCCACTCATAACA-1	SMC
GAGTCTGACTATAGAA-1	Endothelial
GAGTCTGGTGAATGAG-1	Adipocyte
GAGTGCCGCATTAGGC-1	Fibroblast
GAGTGGAGCAAGCGCA-1	Adipocyte
GAGTTACTCAATGGAA-1	SMC
GAGTTCTATCGTGCCT-1	SMC
GATAAGCACGTGCGTA-1	Endothelial
GATCCACCGCGTGCAA-1	Macrophage
GATCGGAGATACGCAG-1	SMC
GATGCCTAGAGTCTGT-1	Macrophage
GATGTAGCGAGGTCCA-1	SMC
GATGTAGGAGTTGGCC-1	SMC
GATTCCATACTGAACC-1	SMC
GATTCCATTGAGTTGA-1	Adipocyte
GATTCCGCTGCAAGAT-1	SMC
GATTCCGTGCGTATAC-1	SMC
GATTGTCGCAACGAGG-1	Adipocyte
GCAACATACATCAGCA-1	Endothelial
GCAAGATAGGTTAACT-1	Macrophage
GCAATACATGAGGACA-1	SMC
GCAATTAATCAACGTA-1	Fibroblast
GCACCTTAGCCTCGCA-1	SMC
GCACTGGACGCAGCAC-1	SMC
GCAGGCTACCGTCCTT-1	Adipocyte
GCAGGCTGGTTCCAAG-1	Fibroblast
GCATGACGGATTATCA-1	Macrophage
GCATTACCTGTCAAGA-1	Adipocyte
GCATTGACTACAGCGA-1	Macrophage
GCATTGGTTACCAAGC-1	Adipocyte
GCCACTATAGACCATA-1	Endothelial
GCCAGACAGACGCCTA-1	SMC
GCCAGACATCTATCAC-1	Adipocyte
GCCGAAGATGTATTGA-1	Fibroblast
GCCGAGTCCTCGTCCA-1	SMC
GCCGCTGATTGGCCAG-1	Adipocyte
GCCGGCGTGAACTTGC-1	Macrophage
GCCGTATGCCAGTCTT-1	Fibroblast
GCCTCCTGCGGCCGTT-1	Fibroblast
GCCTGGAGCAAGTTAG-1	Endothelial
GCCTGGTACATGGTCG-1	SMC
GCCTGGTCAGGTTGCC-1	Macrophage
GCCTTGAGATCTGAGC-1	SMC
GCCTTGCCACTTCTGA-1	SMC
GCCTTGGCGAACAATC-1	Fibroblast
GCGAATAGTGGCTAAT-1	SMC
GCGAATCGAGAACACG-1	Adipocyte
GCGACAGTGCCGCACC-1	SMC
GCGAGCGGACCATAAC-1	SMC
GCGAGCGGTTGTCATG-1	Endothelial
GCGATGACCGTGTAAT-1	Macrophage
GCGGCAAGTGTTATGT-1	Adipocyte
GCGGTGGCCGACGCAT-1	Macrophage
GCGTACCGGATGGCTC-1	Endothelial
GCGTACCGTGTATCAG-1	Macrophage
GCGTCGGAATGCTGCC-1	SMC
GCGTCGGTCACGCCAG-1	Endothelial
GCTACCATCCTGTAGA-1	Fibroblast
GCTATGCGTGAACGGT-1	Fibroblast
GCTCAACCACGGCAAC-1	Adipocyte
GCTCATACAATTAGAC-1	SMC
GCTCGGAGATGAATGT-1	SMC
GCTGACAGCCGGAGCG-1	Macrophage
GCTGTAGTGCTGTCGC-1	Adipocyte
GCTGTTGATAGTCTTA-1	Adipocyte
GCTTCTAAGTCTGACG-1	SMC
GCTTCTAGCGTTCATT-1	Macrophage
GCTTCTTGGACGAGCG-1	Endothelial
GCTTGCTTACTTAACG-1	Endothelial
GCTTGGATCCAACCGG-1	Fibroblast
GCTTGGATGCTCGCTT-1	Adipocyte
GCTTGGCTGCGGTAAC-1	SMC
GGAACTTCGACATGTC-1	Fibroblast
GGAAGCTATGGCACAG-1	Fibroblast
GGAATCCTTAGACTGT-1	Macrophage
GGAATGGCAACTTGGA-1	Adipocyte
GGACAGTGCGGCAACA-1	Endothelial
GGACCGCTTCCTGGCA-1	Macrophage
GGACGTCGCACGAGAA-1	SMC
GGACGTTGGAGGTGAT-1	SMC
GGAGATCCTGTACCAG-1	SMC
GGAGTCTAAGTGGTCC-1	Endothelial
GGATAATTCAATGCTG-1	Endothelial
GGATCGCTGGCATATT-1	Endothelial
GGCAGCGTATACGACT-1	Adipocyte
GGCAGGAAGTCTTCTA-1	Fibroblast
GGCATAATCCTATCGC-1	SMC
GGCATTGCTAAGAATG-1	Macrophage
GGCGAGGCAGCCTACT-1	Fibroblast
GGCGGAAGTCTTGTAG-1	Fibroblast
GGCGGAGCACTGATAA-1	SMC
GGCGTGTAATTACTTA-1	Adipocyte
GGCTTGCCATAGGCTC-1	Fibroblast
GGTAAGGCGACGATGA-1	Macrophage
GGTACCAGGTAGTGTT-1	Fibroblast
GGTACGGAGCATCAGC-1	Fibroblast
GGTAGCCATCAATCCG-1	Endothelial
GGTCCTGCGAGTAGGT-1	SMC
GGTCTGAAGGTTCGAA-1	SMC
GGTCTGAAGTATGTCA-1	Adipocyte
GGTCTGCGAACTGTAT-1	Adipocyte
GGTCTTATAGGCTGGC-1	Adipocyte
GGTCTTGAACCGGCCA-1	Macrophage
GGTCTTGATAACGTCA-1	Endothelial
GGTGCAGGCACCGCGT-1	SMC
GGTGCAGTGGTCTTAT-1	Endothelial
GGTGTCACCAGCGAAC-1	Fibroblast
GGTTCATTCCGGCCTC-1	SMC
GGTTCTGGAGTCTACC-1	Fibroblast
GTAACACCGAGCGTTA-1	SMC
GTAATCACGCACAGCT-1	Fibroblast
GTACAACTCGGCAGAA-1	Macrophage
GTACAGAACAGGACTC-1	SMC
GTACCTGAAGTGAATG-1	Adipocyte
GTACGAAGGATTATTG-1	Endothelial
GTACGAATTCTACCAA-1	Fibroblast
GTACGATTAGTCTACA-1	SMC
GTACTTAACTTCAGCG-1	Endothelial
GTAGAAGGACATCATA-1	Macrophage
GTAGCATAGTTACAGG-1	Endothelial
GTATGACATAAGACGG-1	SMC
GTATGATAGTATGGAT-1	Fibroblast
GTATGATCACTTGACG-1	SMC
GTATGTTAGTTCTACC-1	SMC
GTATTAGATTGAGGTC-1	Fibroblast
GTATTATGAGTTAGCG-1	Macrophage
GTATTCCAAGTTACCT-1	SMC
GTATTCGTGACTTGAT-1	Endothelial
GTCAACAGTTAAGTGA-1	SMC
GTCAACCTGACGATAG-1	SMC
GTCACTAAGCCAGCGG-1	Fibroblast
GTCAGCGATGTAATTG-1	Macrophage
GTCAGTAGGTGACCGG-1	Fibroblast
GTCAGTGAGGATCGTT-1	SMC
GTCAGTGCTGACAGCG-1	Fibroblast
GTCAGTTCTGCCTGGA-1	Endothelial
GTCATCACGTGGTTCA-1	Endothelial
GTCCGACAGCCGCATT-1	Fibroblast
GTCCTTCATCAGATCA-1	Macrophage
GTCTAATACGGCTAAG-1	Endothelial
GTCTAGTCTAGCGACG-1	SMC
GTCTTGACAATAGCAA-1	SMC
GTCTTGCGATGAATGC-1	SMC
GTCTTGCGGCGATTCA-1	Adipocyte
GTCTTGCTGGACGATA-1	Endothelial
GTGAACATTCAACGAT-1	Endothelial
GTGAAGATGAGTGCCT-1	Adipocyte
GTGAAGTGATCGTGCT-1	Fibroblast
GTGACACCAAGTGAAT-1	Fibroblast
GTGACATACAGGTCCT-1	Endothelial
GTGACCAGATCGAGAT-1	Endothelial
GTGACTTCCTCACGAC-1	Endothelial
GTGCAACGACGGTGTT-1	SMC
GTGCACTTGTTCCTGG-1	Fibroblast
GTGCAGGCTGGACATG-1	Endothelial
GTGCATGGTTGAGTTC-1	Endothelial
GTGCCTGACACGTTGG-1	Endothelial
GTGGAACAGAAGTCGA-1	SMC
GTGGCGAGGAAGGCTA-1	Fibroblast
GTGGCGCACCTGTTCC-1	Fibroblast
GTGGTACTGTTGTAGC-1	SMC
GTGGTCGCTCTGTAGC-1	SMC
GTGGTTGCCGCTTCAA-1	Macrophage
GTTAACAACTTCGGAT-1	Fibroblast
GTTAACTCCGACCACT-1	SMC
GTTAGGCCTGAACATC-1	SMC
GTTAGGTACTAACTGG-1	Fibroblast
GTTCATCTTACATTCC-1	Adipocyte
GTTCCAGTGCCTTACC-1	Fibroblast
GTTCTTGATCTGTTGA-1	SMC
GTTGAAGGAAGTCGGC-1	SMC
GTTGAATCAACCTGGC-1	SMC
GTTGACGAACCAGAAC-1	Adipocyte
GTTGACGGATAGCCAT-1	Fibroblast
GTTGACTAGAGCACGT-1	Macrophage
GTTGCTCCTGAGATTC-1	SMC
GTTGTCCTGTGATGTA-1	Macrophage
TAACAGCAGGCCTTAC-1	SMC
TAACAGGAACCGACAA-1	SMC
TAACAGGTCCATACCA-1	SMC
TAACATGGCCACCTCC-1	SMC
TAACCTTGAGACTTCG-1	Fibroblast
TAACGAGCCGAAGGTC-1	Adipocyte
TAACGAGTTGCCAACC-1	SMC
TAACGCGTAATATGGC-1	Endothelial
TAACGCTTATGCCATA-1	SMC
TAACGTCACTATAATC-1	Adipocyte
TAACGTTGCGTCGATG-1	Endothelial
TAAGCACGAGACCTAC-1	SMC
TAAGCCATACGACACG-1	Fibroblast
TAAGCTCCTTCACGCC-1	Fibroblast
TAAGGACGCCTGGTTG-1	SMC
TAAGTGGCCGCTCACC-1	Adipocyte
TAAGTGTCAAGGTGGC-1	Fibroblast
TAATAGCGCTGTACTC-1	Fibroblast
TAATCGACATTGTTGG-1	SMC
TAATGTGCACGATCTG-1	Endothelial
TAATTAAGGAGTACTG-1	SMC
TACAAGCGGAAGTACG-1	Endothelial
TACACTGCAGGTTAGA-1	SMC
TACACTGTCGAACCAA-1	SMC
TACATCGTCAGCGGTT-1	Endothelial
TACCAGACAACCTCAG-1	SMC
TACGACGCGATTCAAG-1	Adipocyte
TACGAGATTGGTCTGT-1	SMC
TACGGAGTCAACGAAG-1	SMC
TACGGATCAGCCATCC-1	SMC
TACGTATCGAGGTTGT-1	SMC
TACTAGTACCGGATGG-1	SMC
TACTATGTTGAATCTT-1	Fibroblast
TACTCCGAAGTAGAAT-1	Adipocyte
TACTCCTACATCAACT-1	SMC
TAGACCGGCCAGTACG-1	SMC
TAGAGGCGATTGATTC-1	Macrophage
TAGCGGACCACTGTTA-1	Fibroblast
TAGCGTATAGCGCTAA-1	SMC
TAGCTAGAAGCGATCA-1	Adipocyte
TAGCTCGAATCGTCCG-1	SMC
TAGCTTAAGCTGGCGT-1	Adipocyte
TAGGATGCACCGTTCA-1	Macrophage
TAGGCATCTGCGGACC-1	SMC
TAGGCGAGCGATCGGT-1	Fibroblast
TAGTATAACCTCGACA-1	Fibroblast
TAGTATCCAATTACGT-1	SMC
TAGTGAGGACATGTTG-1	Adipocyte
TAGTGATGACTCCTGG-1	Adipocyte
TATCAACGAATATGAG-1	SMC
TATCAAGGCCGCGTGG-1	SMC
TATCAATGCCGCTCAC-1	SMC
TATCACTTCGAGCCGT-1	Adipocyte
TATCCACTTGCGTATC-1	Macrophage
TATCCTGCGGTTGATC-1	Fibroblast
TATCTAATCACCTCGG-1	Fibroblast
TATCTAGGAGTGGACA-1	Fibroblast
TATCTAGTCGCATGCA-1	Fibroblast
TATGACAATGCTTGAA-1	Macrophage
TATGACGGAGATTGGC-1	Macrophage
TATGAGGATCTACTGG-1	Fibroblast
TATTGAATCCGACTAA-1	Endothelial
TATTGATCGTGATCTT-1	SMC
TCAAGGCAACGCGGCT-1	Fibroblast
TCAAGGTATCAACTTA-1	SMC
TCACAAGCTCGAGGCA-1	Adipocyte
TCACATCCTGTCGCGG-1	SMC
TCACATCCTTCTCAGT-1	Fibroblast
TCACATTGTCGGTGAC-1	Endothelial
TCACCGTTGCTAATGG-1	SMC
TCACGACATCAGAAGG-1	SMC
TCACGATACCTAGCCA-1	SMC
TCAGCGTGACCTTACC-1	SMC
TCAGCTACCAACTCCG-1	Endothelial
TCAGCTAGGATGTACT-1	SMC
TCAGCTATTAATCGCT-1	SMC
TCAGGAGCAACGGTCG-1	Macrophage
TCAGGATACACTACAA-1	Endothelial
TCAGTATGTAGGACAA-1	Fibroblast
TCAGTCAGCGATCAGA-1	Fibroblast
TCAGTCGCCAAGGTTG-1	Macrophage
TCATAGCTTCCAGTAC-1	Adipocyte
TCATAGGTGAGTCGAC-1	Endothelial
TCATCGTTATGTATCT-1	SMC
TCATGAGTAAGACATC-1	Fibroblast
TCATTGATAGACTTGC-1	Fibroblast
TCATTGTTCAATGCGT-1	Endothelial
TCCAACTAAGACTCCA-1	Adipocyte
TCCAACTGAATAAGGT-1	Adipocyte
TCCAACTGCCGCCATA-1	Adipocyte
TCCAATCTAACACGCA-1	SMC
TCCAGTACGTGCTATG-1	SMC
TCCATGATGTGATCAA-1	Adipocyte
TCCATGCGTCCACCAG-1	Endothelial
TCCGAACATAGTCTGA-1	SMC
TCCGAACCTCAACCAT-1	SMC
TCCGCCAGTGATTAAT-1	Macrophage
TCCGGCTCTATGGACA-1	Endothelial
TCCGTCCACTCGGAGC-1	SMC
TCCGTGTCTTACATAA-1	Macrophage
TCCTCACGTGTAGACG-1	Adipocyte
TCCTGATAAGTGCCGT-1	Adipocyte
TCCTGGTGGCAATAGC-1	Macrophage
TCCTTACTCGCAATGA-1	Fibroblast
TCGACGAAGAGCAAGT-1	Macrophage
TCGAGTGGTAGGTCAC-1	Adipocyte
TCGATCCAGTCTGTAG-1	Fibroblast
TCGATCGTGAGGCGCC-1	Endothelial
TCGCACTGTACGGCGA-1	SMC
TCGCCTATCGACTCCT-1	Macrophage
TCGCCTGGTGGATTCT-1	Endothelial
TCGGAACGTCTGCAAG-1	SMC
TCGGCGCAGAATGTCT-1	Macrophage
TCGGCGCAGATAGATA-1	Adipocyte
TCGGTGTCTAACCAAG-1	SMC
TCGTATCACGTTATGA-1	SMC
TCGTCCAGCATGGCTT-1	Macrophage
TCGTGCCTCGGTAGTT-1	SMC
TCTACAACTGGAACTT-1	Endothelial
TCTACATGTCCGACTT-1	SMC
TCTAGGCGGAAGGCAC-1	SMC
TCTGCGTGCTTCAGAC-1	Macrophage
TCTGGATATTAACCTA-1	Endothelial
TCTGGTATCTGTAGCC-1	Endothelial
TCTGTCACCGTTAATA-1	Fibroblast
TCTTACCGCTCGTATG-1	SMC
TCTTACTGAGACTAGT-1	Adipocyte
TCTTAGTCGTCTCGGC-1	Macrophage
TCTTGAGTCATTATAC-1	Adipocyte
TCTTGCACTATTCAGA-1	Endothelial
TGAACGGACACGTATC-1	Adipocyte
TGAAGCACCGTCATGA-1	SMC
TGAAGTATGATCGTGC-1	Macrophage
TGAATGTACCTTCGTC-1	Fibroblast
TGAATGTTGACATCGT-1	Adipocyte
TGAATTCGTGGTATAA-1	Fibroblast
TGACATTACAACGCCG-1	Fibroblast
TGACCAAGCTGCACAT-1	Fibroblast
TGACCAATCAGCCACG-1	Adipocyte
TGACCAGCACTCCAGC-1	SMC
TGACCAGGTATGACCT-1	Endothelial
TGACTTGCACTCACGG-1	Endothelial
TGAGGTAGGACTACTG-1	Adipocyte
TGAGTGAGATCGCTAA-1	Fibroblast
TGATGGCCGGCATCGC-1	Adipocyte
TGATTAGAATGACATA-1	SMC
TGCAACAGTGAAGCTC-1	Endothelial
TGCAACGTTACCTGGT-1	Macrophage
TGCACGTAGTTCGAAG-1	Adipocyte
TGCACTCCAGCTACTC-1	Endothelial
TGCAGACAATACTGTT-1	Fibroblast
TGCAGTTATTCCACTC-1	SMC
TGCATTAATGGCCACC-1	Adipocyte
TGCATTGCTGTCGGCG-1	Macrophage
TGCCAATCCATGTCTA-1	Endothelial
TGCCAGGATGAGGTTC-1	Adipocyte
TGCCTAAGTTAATTAT-1	Macrophage
TGCCTATCAATGCCAT-1	Endothelial
TGCGAGCCAGACGAAT-1	SMC
TGCGATTAGCTCCGCC-1	Endothelial
TGCGCCGATCGCGAAG-1	Fibroblast
TGCGCCTCTGGCTACA-1	Fibroblast
TGCGCTCATAGAACGA-1	SMC
TGCGGACTCACGTGAT-1	Adipocyte
TGCGGATCATCCTAGA-1	Fibroblast
TGCGTGTCGGCGGATA-1	Fibroblast
TGCTATCCATGTAATA-1	Macrophage
TGCTTAGCTCCTGGCT-1	Fibroblast
TGCTTATGACGCTGGC-1	SMC
TGGACGCCTGCGACCG-1	Endothelial
TGGAGTGCTCCTGATC-1	SMC
TGGATCCAGTCACTTC-1	Adipocyte
TGGCCAACATTCTGAG-1	Fibroblast
TGGCCAAGCGTACAAG-1	Fibroblast
TGGCCAGAGTATCTCC-1	Endothelial
TGGCCAGATCCGGACA-1	SMC
TGGCCTGACATACTCA-1	Macrophage
TGGCGACACTGCCGGA-1	Endothelial
TGGCTCCGCATCAGAT-1	SMC
TGGTACGGACGTAGTT-1	Macrophage
TGGTACGTGCTGTTGA-1	SMC
TGGTAGCATCAAGTCT-1	Adipocyte
TGGTAGCCAGTTGACA-1	Endothelial
TGGTATGCAAGTCTAT-1	Adipocyte
TGGTATTCCTAGTCCA-1	Fibroblast
TGGTCGCCGGCTTACT-1	Adipocyte
TGGTCTCAGAATGCAC-1	Fibroblast
TGGTGCAGACCGAAGT-1	Fibroblast
TGGTGCGAGGTCGTAT-1	SMC
TGGTTGAACACGCCAA-1	SMC
TGGTTGCCTCCGGCTT-1	Endothelial
TGTAAGGTGAGCGACC-1	SMC
TGTAATTGTATCCTCG-1	SMC
TGTACCAACTACGCAT-1	Fibroblast
TGTCAACTCATCAACG-1	Fibroblast
TGTCAGAAGTTGTAAC-1	Endothelial
TGTCATGCATGAGCAC-1	Endothelial
TGTCCATGTATGGAAT-1	SMC
TGTCTTGCGACTAATT-1	SMC
TGTTCCTCACATTAAT-1	SMC
TGTTGGAACGAGGTCA-1	SMC
